##############N
#.EEGEEEEEGEE.#
###EEEEGEEEE###
#G#.EEEEEEE.#G#
#E###EEEEE###.#
#EEG#.EEE.#E#.#
#EEE###E###E#.#
#EEEE.#.#.EE#.#
#EEEEE#.#.EE#.#
###############
