##############N
#EEEGE#EE#GEE.#
#.#EEE#GEEEE..#
#G#.EE#EEEE..G#
#E.E.#EGEE##..#
#EE...EEE.#E..#
#EE.#E.E###E..#
#EE#E.#.#.EE..#
#E#EE##.#.EE..#
#.###########.#
