##############N
#E.EEEE#EGE#.E#
#EEE..#G#.G####
#G#EE#E..E.EEG#
#E#EG#EG.E#.E.#
#E##.E#.E.#E.E#
#E##G.E##G.#EE#
#E.EEEE#G.E..E#
#E#EEE.#EEEEEE#
#.#############
